######
#    #
# #A #
# @$ #
# o$ #
#    #
######