######
#    #
# #  #
# @B #
# $$ #
#    #
######