 #####
#o  ##
# @  #
##A@ #
 ##  #
  ##o#
   ###